NO ./textures/north.xpm
SO ./textures/south.xpm
WE ./textures/west.xpm
EA ./textures/east.xpm

F 30,56,0
C 0,255,0

1111111
1N00001
1000001
1000001
1111111
